00000000000000000000000000000000000000000000000000000000000000000000000000000000000000000000000000000000000000000000000000000000000000022200000000000000000000000000000252000000000000000000000000002222120000000000000000000000000025414222000000000000000000000000222341520000000000000000000000000024222200000000000000000000000000252000000000000000000000000000002220000000000000000000000000000000000000000000000000000000000000000000000000000000000000000000000000000000000000000000000000000000000000000000000000000000
00000000000000000000000000000000000000000000000000000000000000000000000000000000000000000000000000022222000000000000000000000000000231120000000000000000000000000002144202220000000000000000000000021412025200000000000000000000000222122252000000000000000000000000221111520000000000000000000000002111211200000000000000000000000021112222000000000000000000000000222220000000000000000000000000000000000000000000000000000000000000000000000000000000000000000000000000000000000000000000000000000000000000000000000000000000
00000000000000000000000000000000000000000000000000000000000000000000000000000000000000000000000000000000000000000000000000000000000022222220000000000000000000000000211111222000000000000000000000022422211120000000000000000000000213141141200000000000000000000002155214122000000000000000000000022552111200000000000000000000000022222222000000000000000000000000000000000000000000000000000000000000000000000000000000000000000000000000000000000000000000000000000000000000000000000000000000000000000000000000000000000000
00000000000000000000000000000000000000000000000000000000000000000000000000000000000000000000000000000022220000000000000000000000000002211200000000000000000000000000023412000000000000000000000000000224122000000000000000000000000002214120000000000000000000000000025411200000000000000000000000000255652000000000000000000000000002222220000000000000000000000000000000000000000000000000000000000000000000000000000000000000000000000000000000000000000000000000000000000000000000000000000000000000000000000000000000000000
00000000000000000000000000000000000000000000000000000000000000000000000000000000000000000000000000000000000000000000000000000000000002222200000000000000000000000000023122200000000000000000000000000214112000000000000000000000000022212122000000000000000000000000252121120000000000000000000000002541121200000000000000000000000025111412000000000000000000000000222222220000000000000000000000000000000000000000000000000000000000000000000000000000000000000000000000000000000000000000000000000000000000000000000000000000
00000000000000000000000000000000000000000000000000000000000000000000222222200000000000000000000002222111112000000000000000000000021115222120000000000000000000000212121111220000000000000000000002121414251200000000000000000000021211611212000000000000000000000215241412120000000000000000000002211112121222000000000000000000002122251111320000000000000000000021111122111200000000000000000000222222222222000000000000000000000000000000000000000000000000000000000000000000000000000000000000000000000000000000000000000000
00000000000000000000000000000000000000000000000000000000000000000000000000000000000000000000000000000000000000000000000000000000000002222222000000000000000000000000221121320000000000000000000000002111241200000000000000000000000024114112000000000000000000000000214221120000000000000000000000222141212200000000000000000000002555551120000000000000000000000022222222200000000000000000000000000000000000000000000000000000000000000000000000000000000000000000000000000000000000000000000000000000000000000000000000000000